admonition - 警告；告诫
aggrieved - 愤愤不平的；感到受委屈的；受害的
allotment - 分配
anguish - n.痛苦
attendant - n.侍者
augment - adj.增大
bon-mot - 妙语；警句
bower - 树荫处；阴凉处
calibrate - 校准
carve - 刻；雕刻
cede - vt.放弃；割让（领土）
clinch - 成功取得；赢得；提供解决办法；确定
concoction - n.混合物
conducive - adj.有益的
constellation - 星群；星座
cortex - n.皮层
crush - n.拥挤的人群
demarcation - n.划分；划界
despoil - vt.掠夺
diverge - vi.分歧，分叉
enticing - 有诱惑力的；诱人的；有吸引力的
equivocal - 模棱两可的；意义双关的
espoused - vt.信奉；支持
extraterrestrial - 地球外的；外星球的；宇宙的
feral - adj.野生的
footman - 侍者
functionary - n.官员
gild - v.镀金
gratify - 使高兴；使满意；满足（愿望、需要等）
grieve - vi.悲痛，哀悼
indubitable - 不容置疑的
infrared - n.红外线
inscrutable - adj.神秘的；不可理解的
insolent - 粗野的；无礼的；侮慢的
jibe with - 与...一致；符合...
knick-knack - n.小玩意
languish - vi.憔悴；凋萎；失去活力
liveried - adj.穿制服的；穿规定服装的
lounge - vi.懒洋洋地趟卧；闲混
mannerism - 习性；言谈举止
marshal - 空军元帅；司仪；典礼官；（美国法院的）执行官
melodramatic - adj.夸张的
modulate - 调节；调整；
morph - vt.改变，变形
nitty-gritty - 〈非正式〉本质；事实真相；实质问题
pang - n.剧痛
panoply - n.全套华服
peer - 仔细看；端详
pigmentation - 染色；着色；色素沉淀
pinprick - （光等的）点；小孔；针孔；
prescribe to - 遵守
prod - 戳；杵；捅；催促；刺激
protagonist - n.主角
provision - n.规定；条款
quibble - 发牢骚；斤斤计较
repudiated - vt.批判，否定
retrieval - n.取回，回忆
scrap - 丝毫；一丁点；残羹剩饭
sleek - adj.油光水滑的
slunk - v.偷偷摸摸地走
sovereignty - n.主权
strong - adj.多于...的
stud - 散布
supercilious - adj.傲慢的
swindle - n.欺诈；骗局
tapestry - 挂毯；织锦；壁毯；绣帷
tentative - 尝试性的，不确定的
transcendent - 卓越的；杰出的；极其伟大的
trivial - adj.琐碎的；琐细的
uphold - 支持
woo - vt.追求
yardstick - n.标准