altruistic - adj.利他的，无私心的
annal - 纪事录
arbitrary - adj.主观的，武断的
basin - 盆地
bent on - 下定决心做；致力于；一心想
brood - 传种用的
clemency - n.宽容；（尤指气候等）温和
clerk - 职员；文书；簿记员
dazed - adj.眩晕的；茫然的；神魂颠倒的
deliberative - 考虑过的；协商的
dispensable - 可有可无；不必要；不重要
fecundity - n.多产；富饶
fledged - adj.（指鸟）羽翼丰满的，会飞的
forgo - vt.&vi.放弃
foster - 培养；促进；鼓励；助长
impostor - n.冒名顶替者，骗子
innate - adj.天生的；固有的；内在的
internecine - 内讧的；两败俱伤的；自相残杀的
intervention - n.干涉；调解
payoff - 收益；回报
peg - 与...挂钩
pinpoint - vt.确定，准确地指出；精确定位
pivotal - adj.中枢的；关键的
plumb - 垂直；铅锤；探索
rampant - adj.蔓延的；猖獗的
reciprocally - adv.相互地，相反地
rift - 劈开
rim - （圆形物体的）边沿
self-serving - adj.自私的
spew - （使）喷出
vain - 徒劳的；枉然的；无结果的
validate - vt.使生效