accusation - 控告；起诉；告发；谴责
agglomerate - 聚集；
alloy - 合金；
annihilate - 消灭；毁灭；歼灭；彻底击败
aptitude - 天赋；天资；天生的才能
arthritis - 关节炎
ashamed - 羞愧；惭愧；尴尬；因惭愧而不情愿
breastfeed - 用母乳喂养；哺乳
brittle - 硬但易碎的；脆性的；脆弱的
calm - 泰然自若的；(海洋,天气等)安静的；若无其事的；静寂的
cascade - 奔流；瀑布
chauffeur（勿背） - 为某人开车；当司机
cognitive - 认知的；感知的；认识的
collar - 抓住；捉住；揪住；逮住
commend - 推荐；表扬；举荐；受到赞同
compatible - 兼容的；可共用的；可共存的；（因思想、志趣等相投而）关系好的
compile - 编译；编写（书、列表、报告等）；编纂
delinquent - adj.有违法倾向的；拖欠债务的；欠债未还的；到期未付的 n.少年罪犯；懈怠者；过失者；违犯者
discount - 低估；认为...不重要；对...不全信
discretion - 谨慎；慎重；审慎；自行决定的自由
disguise - 伪装；掩饰；假扮；装扮
dissection - 解剖；
downsize - 缩小规模
duel - 决斗
enmity - 敌意；敌对；仇恨
fickle - 易变的；无常的；反复无常的
flush - 富有
free rein - 完全自由；行动完全自由；自由毫无拘束
gorge - n.峡谷 v.贪婪地吃；狼吞虎咽
gourmet - 美食家
grocery - 食品杂货店
haul - 拉；用力缓慢挪动到（某处）；强迫（某人）去某处；使某人出庭受审
impair - 损害；削弱
impediment - 障碍；阻碍；妨碍
impute - 把...归咎于；把...归因于；把...转嫁于
inarticulate - 不善于表达的；不善于说话的；词不达意的
interface - 接口；界面
interstitial - 【物】填隙
irradiation - 发光；扩散；辐照；辐射
itinerary - n.行程；旅行日程 adj.巡回的；旅行的；巡回中的
lattice - 晶格；点阵；格点
lean year - 荒年
misalign - 偏离；
neurotic - 神经症的；神经官能症的；神经质的
out of the question - 不可能的
overdue - 未做的；过期的；早该发生的；早应完成的
overture - 友好姿态；建议
particularity - 特性；个性；特征；细节
phenotypic - 表型的
posit - 假设；认定；认为...为实
privilege - 特殊利益；优惠待遇，荣耀；
protest - 抗议；（公开）反对；坚决地表示；申辩
quaint - 稀奇古怪的；古雅的
ratify - 正式批准；使正式生效
reconcile - 调和；使和谐一致；使配合；使和解
resilience - 适应力；弹力；快速恢复的能力；还原能力
roadblock - 拦路虎；路栅；障碍物
roster - 值勤名单；候选名单
scarce - 缺乏的；不足的；稀少的
scarlet - 猩红的；鲜红的
scruple - 良心上的不安; 顾虑，顾忌
seesaw - n.跷跷板(戏)；上下动；前后动；动摇 v.交替；(温度等)升降；涨落；玩跷跷板戏 adv.上下动地[的]；前后动地[的]；交互地[的]；拉锯性地[的]
shew - 侧斜
slipcover（勿背） - n.沙发套
sophistication - 诡辩；强词夺理
stirring - adj.令人激情澎湃的；激动人心的 n.出现 v."stir"的现在分词，搅拌，激起；
stubborn - 固执的；执拗的；顽固的；倔强的
swell - 膨胀，使突出；
trigger - 触发；引起；发动；开动
uptick - （程度或价值的）小幅上升
utero - 子宫
vice versa - 反之亦然；反过来也一样
void - 空白；空虚；空间；真空
wayward - 难以控制的，任性的；
weather - 风化
zap - 打击；很快地做；迅速做
zoom - 【摄影】可变焦距镜头 v.快速移动；嗡嗡地活动；急剧增长；猛涨
zoom in - 放大；拉近