accentuate - vt.强调；重读
adduce - 引证；举出；提出；引用
aficionado - (某方面的)狂热爱好者
aisle - 走道；过道
antic - 滑稽的；古怪的；滑稽动作
ardent - adj.热情的；热心的
assault - n.攻击；袭击；vt.攻击；袭击
bellow - n.吼叫声；轰鸣声
blemish - n.瑕疵；污点；vt.玷污；损害
blight - vt.破坏；使...枯萎；vi.枯萎
blindfold - 眼罩；遮眼布
border on - 相邻于；近似于
bountiful - adj.丰富的；慷慨的
brainchild - n.脑力劳动的产物
camouflage - n.伪装，掩饰；vt.伪装，掩饰
chronicle - n.记录；vt.记录
compartment - 隔间
concede - vt.承让；退让
cordial - adj.热忱的，诚恳的
dash - 猛冲；猛掷
defenseless - adj.无防备的
demise - n.死亡，终止
dip - （通常指暂时的）减少；下降
dispassionate - adj.不带感情的；平心静气的；公平的
elusive - adj.难懂的；难捉摸的
embolden - vt.使有胆量，使大胆
endearing - adj.可爱的；讨人喜欢的
fall short - come short，不足；达不到；缺乏
fickle - adj.变幻无常的
foreshadow - vt.预示；成为...的前兆
gnat - 叮人小虫；
groundbreaking - adj.开创性的
grumbled - vi.抱怨；嘟囔；n.怨言
hospitable - adj.热情友好的；（环境）舒适的
inattentive - 不注意的；不经心
incite - 煽动；鼓动
inhibition - n.抑制；压抑
innumerable - adj.无数的，数不清的
insular - adj.孤立的；与世隔绝的
invariably - adv.总是；不变地；一定地
maze - 迷宫
militate - 发生影响；战斗
mitigate - vt.使缓和，使减轻；vi.减轻，缓和
nostalgia - n.乡愁；怀旧之情
notorious - adj.声名狼藉的，臭名昭著的
objectionable - adj.讨厌的；会引起反对的
obliterate - vt.消灭；涂去
outlet - （感情、思想、精力发泄的）出路；表现机会
overreach - 贪功致败；不自量力；做事过头
override - vt.推翻；不顾；践踏
pace - 〈美〉(在比赛中)继续领先
pique - vt.激怒；
plead - v.辩护
plow - vt.【农机】犁；耕；开路
prolific - adj.多产的；丰富的
proverb - 谚语；格言
rebound - 反弹；回升；弹回；
reel - 卷筒；卷轴；卷盘
remiss - adj.怠慢的；迟缓的
render - vt.致使；提出
repel - vt.抵制；使厌恶
restoration - n.恢复；归还
rigorous - adj.严格的，严厉的
sagacity - n.睿智；聪敏；有远见
sap - 使虚弱；削弱；逐渐破坏
scuttle - vi.逃避；急促地跑；
shot - 注射
shrewdness - 精明
slam - （使...）砰地关上；用力一放；
suffrage - n.选举权；投票
susceptible to - adj.易受...影响的
terrain - 地形；地带；地势
thermoregulation - 【生】体温调节
token - 表示
torso - （身体的）躯干
traverse - vt.穿过；反对；详细研究；在...来回移动
undeserving - adj.不值得...的；不配受到的
unequivocal - adj.明确的；不含糊的
vaccine - n.疫苗
wander - v.漫游；闲逛
wariness - 谨慎
waver - vi.踌躇
wear off - 磨损；逐渐消逝
wield - vt.使用，行使