apparent - adj.显然的；表面上的
bode - 预示
boisterous - 热闹的；充满活力的；活蹦乱跳的
catchall - n.装杂物的容器；总受器；分沫器
colossal - adj.巨大的；异常的，非常的
coupled with - 加上，外加；与...相结合
daunted - adj.令人害怕的，令人恐惧的
deception - n.欺骗，欺诈；骗术
disembark - 下（车、船、飞机等）
dissipated - adj.消散的；沉迷于酒色的；闲游浪荡的；放荡的
dock - 码头；船坞；船埠；港区
dredge - 疏浚；清淤；挖泥；挖掘
dust - n.灰尘；尘埃；尘土
erode - vt.腐蚀，侵蚀 vi.侵蚀，受腐蚀
escapees - n.逃避者；逃亡者
evaporated - v.蒸发；消失；失去水分
fallout - 后果；余波
fear-mongering - 散布恐怖
fiscal - adj.会计的，财政的；国库的
flare - （短暂的）旺火；（摇曳的）光；（闪耀的）火光
flares - n.喇叭裤
fraud - n.欺骗；骗子；诡计
grapple - 搏斗；努力设法解决
heavyset - 身体强壮的；身材矮胖的
herbicides - n.【农药】除草剂
inhale - 吸入；吸气
irretrievable - adj.不能弥补的；不能复原的；无法挽救的
jovial - 快乐的；愉快的；友好的
luddites - "n.卢德派；卢德分子；
malnutrition - n.营养失调，营养不良
mote - n.尘埃；微粒；小错
oscillation - n.振荡；振动；摆动
out of sync with - 与...不一致
partake - vi.分享；参与；分担；带有某种性质 vt.分担；分享
peek - vi.窥视，偷看
pier - 桥墩；
poised - adj.泰然自若的，镇定的；平衡的，均衡的；摆好姿势不动的，静止的
reassuring - 令人感到宽慰的；令人放心的
relentlessly - adv.残酷地，无情地
scrabble - 翻找；乱抓；乱动
shill - n.雇佣骗子；诱饵
stitch - vt./vi.缝，缝合
surmount - 克服；解决；处于（某物）上面；置于（某物）顶端
sympathetic - adj.同情的；交感神经的；共鸣的；赞同的；和谐的；合意的
syncopated - adj.切分音的
tout - 兜售；吹捧；推销；标榜
touted - v.招来顾客
trail - 跟踪；追踪；
turntable - n.转盘；转车台；转车；旋盘
uncluttered - 简洁的；整洁的；利落的
undermine - vt.破坏，渐渐破坏；挖掘地基
uptick - n.报升（股票成交价格比上一个交易的为高）
viable - adj.可行的；能养活的；能生育的
wary of - 小心翼翼的；警觉的；谨防的